BACH	B AA K
BEETHOVEN	B EY T OW V AH N
COMPUTER	K AH M P Y UW T ER
FLICKS	F L IH K S
HAL	HH AE L
HI	HH AY
LIGHTS	L AY T S
NET	N EH T
OFF	AO F
OKAY	OW K EY
ON	AA N
ON(2)	AO N
PAUSE	P AO Z
PIANO	P IY AE N OW
PIANO(2)	P IY AE N AH
PLAY	P L EY
RESPOND	R IH S P AA N D
RESPOND(2)	R IY S P AA N D
SKIP	S K IH P
SONATAS	S AA N AA T AH Z
STAR	S T AA R
SYMPHONIES	S IH M F AH N IY Z
THERE	DH EH R
TREK	T R EH K
TURN	T ER N
YOU	Y UW
